; english pronounciation is going here after this line rules for the individual words and stems
steeng=sting
seen=s&in
you=ju
the=de
there=der
check=czek
checked=czekt
(close=klołz)*
button=batn
combo=kombo
online=onlajn
offline=offlajn
came=kem
just=dżast
win=łin
window=łindoł
windows=łindołs
(fire=fajer)*
mail=mejl
(thunderbird=fenderberd)*
nvda=envidi&ej
menu=menju
NVDA=en_vi_di_ej
select=selekt
what=łot
play=plej
player=plejer
control=kontrol
base=bejs
bases=bejsys
went=łent
when=łęn
synthesizer=synsesajzer
out=ałt
output=ałtput
cancel=kansel
mode=mołd
(duck=dak)*
(microsoft=majkrosoft)*
store=stor
python=pajton
drive=drajw
longer=londżer
newbie=niubi
(team=tim)*
(zoom=zum)*
device=diwajs
devices=diwajsys
face=fejs
facebook=fejsbuk
messenger=mesendżer
edge=edż
enable=eneibl
disable=dizeiblt
confirmation=konfirmejszyn
dialog=dajlog
confirm=konfirm
are=ar
sure=szur
want=łont
tweesecake=tłiskejk
tool=tul
tools=tuls
notification=notifikejszyn
notifications=notifikejszyns
logged=logt
has=hez
been=bin
main=mejn
day=dej
days=dejs
message=mesydż
messages=mesydzis
playing=plejing
have=hew
(screen=skrin)*
new=niu
news=nius
near=nir
nothing=nołfing
track=trak
tracking=traking
remove=rimułw
removed=rimułwd
number=namber
remover=rimuwer
vocal=wokal
ultimate=altimejd
zip=z&ip
down=dałn
download=danlołd
downloads=dałnlołds
downloading=danlołding
page=pejdż
up=ap
arrow=aroł
gun=gan
shot=szot
come=kom
me=mi
load=lołd
loading=lołding
wave=łejw
waves=łejws
available=eweibl
com=kom
google=gugl
chrome=chrołm
line=lajn
channel=czanel
channels=czanels
voice=wojs
voices=vojsys
join=dżojn
classic=klas&ik
file=fajl
files=fajls
chat=czat
slider=slajder
activate=aktiweit
microphone=majkrofołn
gain=gejn
activation=aktiwejszyn
volume=woljum
winamp=łinamp
sound=sałnd
sounds=sałnds
view=wiu
viewer=wjułer
dvbviewer=DVB_wjułer
Dvbviewer=dvb_wjuer
pay=pej
with=łyf
warning=łorning
delete=dilejt
will=łil
be=bi
deleted=dilejtyd
man=men
woman=łumen
watch=łocz
watching=łoczing
(look=luk)*
buy=baj
bike=bajk
bikes=bajks
password=pasłord
word=łord
stopped=stopt
now=nał
trust=trast
save=sejw
saving=sejwing
root=rut
complete=komplit
completed=komplityd
user=juzer
username=juzernejm
because=bikoz
connect=konekt
connection=konekszyn
remade=rimeid
afk=ej&ef&kej
use=juz
using=juz&ing
storage=storidż
computer=kompjuter
comp=komp
open=ołpen
lock=lok
booster=buster
site=sajd
found=faund
below=biloł
slightly=slajtli
streight=strejt
behind=bihajnd
above=ebaw
right=rajt
your=jor
(speak=spik)*
version=werżyn
speech=spicz
core=kor
reload=rilołd
high=haj
definition=definiszyn
notify=notifaj
back=bek
wish=łiz
hour=ałer
hours=ałers
(ninute=mynyt)*
(fuck=fak)*
every=ewri
everyone=ewriłan
need=nid
administration=administrejszyn
administrations=administrejszyns
bitcoin=bitkojn
bitcoins=bitkojns
coin=kojn
coins=kojns
must=mast
sky=skaj
skype=skajp
skype=a=skajpa
skypie=skajpie
mine=majn
suicide=suisajd
motion=mołszyn
grenade=grinejd
launch=lancz
launcher=lanczer
tail=tejl
tiles=tajls
logout=logałt
again=egejn
manage=menedż
manager=menedżer
cave=kejw
hidden=hidyn
share=szer
sharing=szering
youtube=jutjub
enabled=eneibld
disabled=dizeibld
rock=rok
preparing=pripering
(repair=riper)*
shotgun=szotgan
shoot=szot
show=szoł
shop=szop
connecting=konekting
try=traj
trying=traing
disconnect=dyskonekt
disconnecting=dyskonekting
location=lokejszyn
option=opszyn
options=opszyns
configuration=konfigiureiszyn
default=difołld
outside=ałdsajd
translate=tranzlejt
name=nejm
selecting=selekting
am=ej&em
eject=idżekt
closing=klołz&ing
tree=tri
users=juzers
away=ełej
chats=czats
wood=łud
wooden=łuden
shelter=szelter
(current=karent)*
lake=lejk
compas=kompas
water=łoter
east=ist
west=łest
survive=sur&łajw
wild=łajld
cable=keibl
(it=ajt)em*
iphone=ajfon
iphonea=ajfona
iphone'a=ajfona
iphonem=ajfonem
iphonek=ajfonek
iphonka=ajfonka
(jaw=dżoł)*
(eye=aj)*
dfc=diefs&i
apply=e&plaj
applied=e&plajd
(shield=szild)*
thirst=tirst
(talk=tok)*
(teamtalk=timtok)*
(feel=fil)*
great=grejt
warm=łorm
cold=kold
sit=s&it
sitting=s&iting
sleep=slip
sleeping=sliping
happy=hepi
destroy=distroj
destroyed=distrojd
ball=bol
(fireball=fajerbol)*
(black=blek)*
harry=hary
harryego=harego
potter=poter
(minute=mynyt)*
readme=ridmi
really=rili
medium=midjum
(energy=enerdżi)*
drug=drag
health=helf
battle=batl
battlefield=batlfild
baddlefield=batlfild
(stream=strim)*
(rec=rik)*
(cloud=klałd)*
(espeak=espik)*
github=githab
(request=rikłest)*
currently=karentli
bearware=birłer
only=onli
read=rid
bases=bejsys
receive=ris&iw
(book=buk)*
bug=bag
create=kri&ejd
created=kri&ejtyd
empty=empti
shoes=szuz
(boot=but)*
reboot=ribut
rebooting=ributing
aidin=ajdin
ghaderi=gaderi
summer=samer
winter=łinter
received=ris&iwd
account=ekaunt
paymend=pejmend
choose=czuz
deselect=diselekt
all=ol
wine=łajn
toggle=togl
(blue=blu)*
green=grin
yellow=jeloł
general=dżeneral
card=kerd
notepad=nołtpad
stupid=stjupid
yourself=jorself
shut=szat
thank=feng
key=ki
keygen=kigen
feed=fid
feedback=fidbeg
see=s&i
this=dys
throwing=trołing
weapon=łipon
reloading=ri&lołding
coffee=kofi
under=ander
possible=pos&ibl
maybe=mejbi
mean=min
sweet=słit
run=ran
death=det
boar=bor
etible=e&tibl
mute=mjut
muted=mjutyd
room=rum
roomba=rumba
unavailable=aneveibl
space=spejs
successfully=saksesfuli
change=czejndż
changes=czejndżys
shielded=szildyd
reading=riding
game=gejm
rate=rejt
village=wylydż
fish=fisz
fishing=fiszing
how=hał
knife=najf
volw=łulf
snake=snejk
connected=konektyd
allow=eloł
source=sors
code=kołd
cup=kap
spear=spir
free=fri
ice=ajs
language=len&głidż
support=sapord
keyboard=kibord
other=ader
character=karakter
who=hu
trusted=trastyd
swith=słicz
translation=tranzlejszyn
quest=kłest
quests=kłests
area=ari&a
future=fjuczer
life=lajf
locator=lokejtor
locate=lokejt
table=teibl
(air=er)*
bottle=botl
softether=softeter
music=mjuz&ik
disconnected=dyskonektyd
wall=łol
walley=łolej
glue=glu
modified=modifajd
good=gud
remote=rimołt
object=obdżekt
objects=obdżekts
say=sej
says=sejs
why=łaj
office=ofis
machinegun=mejszingan
please=pliz
many=meni
not=nołt
first=ferst
beer=bir
private=prajwejt
uploaded=aplołdyt
uploading=aplołding
take=tejk
successfull=saksesful
completing=kompliting
finish=fynysz
baseball=bejsbol
power=pałer
neckles=nekles
attention=etenszyn
like=lajk
likes=lajks
here=hir
report=riport
clean=klin
cleaner=kliner
dead=did
lion=lajon
dice=dajs
work=łerk
working=łerking
checking=czeking
update=apdejt
updating=apdejting
updates=apdejds
mobile=mobajl
phone=fołn
wending=łending
machine=meszin
push=pusz
road=rołd
tiger=tajger
catket
cats=kets
case=kejs
boost=bust
wait=łejt
waiting=łejting
verification=weryfikejszyn
challenge=czelendż
authorize=ałsorajz
authorization=ałsorizejszyn
cleaning=klining
challenges=czelendżs
english=inglisz
